bbbbbbbbbbb
b    s    b
b         b
b   ttt   b
b         b
bbbb   bbbb
b         b
b    e    b
b         b
bbbbbbbbbbb