bbbbbbbbb
b       b
b   b   b
b e     b
bb  s b b
b       b
b   b   b
b       b
b       b
bbbbbbbbb