bbbbbbbbb
b       b
b   b   b
b       b
b b s  bb
b     e b
b   b   b
b       b
b       b
bbbbbbbbb