bbbbbbbbb
b       b
b    e  b
b   ttttb
b       b
b       b
b       b
b    s  b
b       b
bbbbbbbbb