bbbbbbbbbbb
b         b
b    s    b
b         b
b         b
b         b
b     e   b
b         b
b         b
bbbbbbbbbbb