bbbbbbbbbbb
b         b
b         b
b    e    b
b   ttt   b
b         b
b   s     b
b         b
b         b
bbbbbbbbbbb